#####################################################################################################
#S                                                                                                  #
#                                                                                                   #
#                                                                                                  E#
#####################################################################################################