#####
#   #
#   #
#   #
#   #
#   #
#   #
#   #
#   #
#   #
#   #
#   #
#   #
#   #
#   #
#   #
#   #
#   #
#   #
#   #
#   #
#   #
#   #
#   #
#   #
#   #
#   #
#   #
#   #
#   #
#   #
#   #
#   #
#   #
#   #
#   #
#   #
#   #
#   #
#   #
#   #
#   #
#   #
#   #
#   #
#   #
#   #
#   #
#   #
#   #
#   #
#   #
#   #
#   #
#   #
#   #
#   #
#   #
#   #
#   #
#   #
#   #
#   #
#   #
#   #
#   #
#   #
#   #
#   #
#   #
#   #
#   #
#   #
#   #
#   #
#   #
#   #
#   #
#   #
#   #
#   #
#   #
#   #
#   #
#   #
#   #
#   #
#   #
#   #
#   #
#   #
#   #
#   #
#   #
#   #
#   #
#   #
#   #
#   #
#E S#
#####
