#####
#SQ #
#  E#
#   #
#####