#####
#S% #
#  E#
#   #
#####