######
#S   #
#   E#
#    #
#####